#################################
#                               #
#         #                     #
#       ###                     #
###########      ###            #
###########    ########         #
###########  ##############     #
#################################